1 2 3 4 1 2 3 4 1 2 3 4
1 2 3 5 1 2 3 4 0 1 2 3
1 2 3 4 1 2 3 4 1 2 3 4
1 2 3 5 1 2 3 4 0 1 2 3
0 1 3 2 3 4 5 0 1 3 4 5
1 2 3 4 5 1 2 3 4 5 1 2

